{
	"numTilesX": 12,
	"numTilesY": 10,
	"start":[48,16],
	"size":[64,64],
	"tilenames": ["","tile01","tile02"],
	"tiles":[ 0, 0, 0, 0, 0, 0, 0, 0, 0, 0, 0, 0,
			  2, 2, 2, 2, 2, 2, 2, 2, 2, 2, 2, 2,
			  2, 0, 0, 0, 0, 0, 0, 0, 0, 0, 0, 2,
			  2, 0, 0, 0, 0, 0, 0, 0, 0, 0, 0, 2,
			  2, 0, 0, 0, 0, 0, 0, 0, 0, 0, 0, 2,
			  2, 0, 0, 0, 0, 0, 0, 0, 0, 0, 0, 2,
			  2, 0, 0, 0, 0, 0, 0, 0, 0, 0, 0, 2,
			  1, 0, 0, 0, 0, 0, 0, 0, 0, 0, 0, 1,
			  1, 0, 0, 0, 2, 2, 2, 2, 0, 0, 0, 1,
			  1, 1, 1, 1, 1, 1, 1, 1, 1, 1, 1, 1 ]
}